NO ./path_to_the_north_texture
SO ./path_to_the_south_texture
WE ./path_to_the_west_texture
EA ./path_to_the_east_texture

F 220,100,0
C 225,30,0

        11111111111111111111111111
        10000000001100000000000011
        10110000011100000000000011
        1001000000000000000000001
111111111011000001110000000000001
1000000001 100100000111011111
11110111111111011100000010001
11110111111111011101010010001
1100000011010101110N000010001
10000000000000001100000010001
10000000000000001101010010001
1100000111010101111101111010111
11110111 1110101 101111010001
11111111 1111111 111111111111